11111111111111111111111111111111111111111111111111
100000000000000000000000000000000000000000000000E1
10000000000000000000000000000000000000000000000001
1000000C00C000C000C000C00C000C00C000C00000C0000001
1000000111100010001000111100C1111C0010000010000001
10000001C01000100010001001000100000011000010000001
1000000100C0001000100010010001C000001C100010000001
100000C1111C0010001000111100C111C00010010010000001
1000000C0010001000100011C00001C0000010001C10000001
10000001C010001C0C10001C10000100000010000110000001
1000000111100011111000100100C1111C0010000010000001
1000000C00C000C000C000C000C000C0C000C00000C0000001
10000000000000000000000000000000000000000000000001
1P000000000000000000000000000000000000000000000001
11111111111111111111111111111111111111111111111111